
Газета ловиньтан я̄тил ма̄хумтēнув! Ты ло̄псыт ма̄н на̄нан то̄рум ва̄рнэ хо̄талыт урыл хансэ̄в, хумус э̄тими, хо̄тыллы, тэ̄лыми манос туйими. То̄рум ва̄рнэ хо̄тал – погода

	Тӯя – весна

	Туи – лето

	Тэ̄лы – зима

	Таквсы – осень 

	Хо̄тал – солнце

	Хо̄тал – день 

	Э̄т, э̄ти – ночь

	Э̄тпос – луна, месяц

	А̄лпыл – утро

	Э̄типа̄ла – вечер 

	Тул – туча 

	Сов - звезда

	Ащирма – холодно

	Рēгыӈжарко

	Сэ̄кв – прохладно

	Вольк – скользко

	Тӯйи – снег идет

	Ракви – дождь идёт

	Во̄тасты – метёт

	Ипырты – заметает, кружит

	Сэ̄гиты – ветер с мелким 

	снегом

	По̄льсамыл мины – град идёт

	Турап хо̄тал – дождливый, 

	пасмурный день 

	Во̄тыӈ хо̄тал – ветреный день 

	Хо̄талыӈ хо̄тал – солнечный 

	день

	Аквтēм хо̄тал – пасмурный 

	день 

	Тӯйт – снег

	Ракв – дождь

	Тӯйтсам – снежинка

	Раквсам – дождинка

	По̄льсам – град

	Во̄т – ветер

	Во̄тпыг – вихрь

	Я̄ӈк соль – сосулька 

	Тӯйт поталы (тӯйт ня̄л) –

	снежок

	Нюлытис – радуга

	Нюлы а̄ӈквал – неполная 

	радуга

	Щищнай – северное сияние

	Щахыл – гроза

	Щахыл во̄т – гроза с ветром

	Щахыл са̄лы – молния сверкает

	Колаланыл ёлаль па̄сги – 

	капает с крыши 

	Туииг ēмтыс – наступило лето

	Тэ̄лииг ēмтыс – наступила зима

	Тӯяг ēмтыс – наступила весна, 

	пришла весна

	Таквсыиг ēмтыс – 

	наступила осень

	Тӯяхлаӈкве – весновать

	Таквсылтаӈкве – осеневать

	Я̄ӈкыг оратас – обледенело

	Сэ̄ӈквыг ēмтыс – туман 

	поднялся

	По̄льсовыӈыг ēмтыс,  по̄лиг ēмтыс – появился наст

	Тӯюӈкве патыс – пошёл снег

	Раквуӈкве патыс – пошёл дождь

	Рēгыг ēмтыс – наступила жара 

	Ащирмаг ēмтыс – наступили 

	холода 

	Во̄тасыг ēмтыс – метель 

	началась 

	Тӯйтравыл парги – идёт 

	мелкий снежок

	Раквсамыл парги – идёт 

	мелкий редкий дождь

	Э̄типа̄лаг сэ̄квыг ēмтыс – 

	вечером стало прохладно

	Хо̄тал ӯнтыс – солнце село

	Хо̄тал нэ̄глыс – солнце встало

	Э̄тпосыӈ э̄т – лунная ночь

	Турман э̄т – тёмная ночь

	Э̄тимаӈкве патыс – начало 

	вечереть (темнеть)

	Турманлаӈкве патыс – 

	начало темнеть

	Сатапаӈкве патыс – только 

	начало темнеть 

	 

	 

	Галина Кондина



Уважаемые читатели! Если вы изучаете мансийский язык, то на этой странице вы можете прочитать слова о природе, о природных явлениях.
Погода – торум варнэ хотал
весна – туя
лето – туи
зима– тэлы
осень – таквсы
солнце– хотал
день – хотал
ночь– эт, эти
луна – этпос
утро – алпыл
вечер – этипала
туча – тул
звезда – сов
холодно – ащирма
жарко – регынг
прохладно – сэкв
скользко – вольк
снег идет – туйи
дождь идет – ракви
метёт – вотасты
заметает, кружит – ипырты
ветер с мелким снегом – сэгиты
град идет – польсамыл мины
дождливый, пасмурный день – турап хотал
ветреный день – вотыӈ хотал
солнечный день – хоталыӈ хотал
пасмурный день – аквтем хотал
снег – туйт
дождь – ракв
снежинка – туйтсам
дождинка – раквсам
град – польсам
ветер – вот
вихрь – вотпыг
сосулька – янгк соль
снежок – туйт поталы (туйт нял)
радуга –  нюлытис
неполная радуга – нюлы ангквал
северное сияние – щищнай
гроза – щахыл
гроза с ветром – щахыл вот
молния сверкает – щахыл салы
капает с крыши – колаланыл ёлаль пасги
наступило лето – туииг емтыс
наступила зима – тэлииг емтыс
наступила весна, пришла весна – туяг емтыс
наступила осень – таквсыиг емтыс
весновать – туяхлангкве
осеневать – таквсылтангкве
обледенело – янгкыг оратас
туман поднялся – сэнгквыг емтыс
появился наст – польсовынгыг емтыс,  полиг емтыс
пошёл снег – туюнгкве патыс 
пошёл дождь – раквунгкве патыс
наступила жара – регыг емтыс
наступили холода – ащирмаг емтыс
метель началась – вотасыг емтыс
идёт мелкий снежок – туйтравыл парги
идёт мелкий редкий дождь – раквсамыл парги
вечером стало прохладно – этипалаг сэнгквыг емтыс
солнце село – хотал унтыс
солнце встало – хотал нэглыс
лунная ночь – этпосынг эт
тёмная ночь – турман эт
стало вечереть (темнеть) – этимангкве патыс
стало темнеть – турманлангкве патыс
только стало темнеть – сатапангкве патыс
Галина Кондина 
